   74   19
   44   40   33  255   45   40   34  255    0    0    0  255    0    0    0  255    0    0    0  255    0    0    0  255    0    0    0  255    0    0    0  255    0    0    0  255    0    0    0  255    0    0    0  255    0    0    0  255    0    0    0  255    0    0    0  255    0    0    0  255    0    0    0  255    0    0    0  255    0    0    0  255    0    0    0  255    0    0    0  255    0    0    0  255    0    0    0  255    0    0    0  255    0    0    0  255    0    0    0  255    0    0    0  255    0    0    0  255    0    0    0  255    0    0    0  255    0    0    0  255    0    0    0  255    0    0    0  255    0    0    0  255    0    0    0  255    0    0    0  255    0    0    0  255    0    0    0  255    0    0    0  255    0    0    0  255    0    0    0  255    0    0    0  255    0    0    0  255    0    0    0  255    0    0    0  255    0    0    0  255    0    0    0  255    0    0    0  255    0    0    0  255    0    0    0  255    0    0    0  255    0    0    0  255    0    0    0  255    0    0    0  255    0    0    0  255    0    0    0  255    0    0    0  255    0    0    0  255    0    0    0  255    0    0    0  255    0    0    0  255    0    0    0  255    0    0    0  255    0    0    0  255    0    0    0  255    0    0    0  255    0    0    0  255    0    0    0  255    0    0    0  255    0    0    0  255    0    0    0  255    0    0    0  255    0    0    0  255   35   31   27  255   49   44   37  255
   47   42   35  255    0    0    0  255  255  231  136  255  255  231  136  255  255  231  136  255  255  231  136  255  255  231  136  255  255  231  136  255  255  231  136  255  255  231  136  255  255  231  136  255  255  231  136  255  255  231  136  255  255  231  136  255  255  231  136  255  255  231  136  255  255  231  136  255  255  231  136  255  255  231  136  255  255  231  136  255  255  231  136  255  255  231  136  255  255  231  136  255  255  231  136  255  255  231  136  255  255  231  136  255  255  231  136  255  255  231  136  255  255  231  136  255  255  231  136  255  255  231  136  255  255  231  136  255  255  231  136  255  255  231  136  255  255  231  136  255  255  231  136  255  255  231  136  255  255  231  136  255  255  231  136  255  255  231  136  255  255  231  136  255  255  231  136  255  255  231  136  255  255  231  136  255  255  231  136  255  255  231  136  255  255  231  136  255  255  231  136  255  255  231  136  255  255  231  136  255  255  231  136  255  255  231  136  255  255  231  136  255  255  231  136  255  255  231  136  255  255  231  136  255  255  231  136  255  255  231  136  255  255  231  136  255  255  231  136  255  255  231  136  255  255  231  136  255  255  231  136  255  255  231  136  255  255  231  136  255  255  231  136  255  255  231  136  255  255  231  136  255  255  231  136  255  255  231  136  255  255  231  136  255  255  231  136  255    0    0    0  255   35   31   27  255
    0    0    0  255  255  231  136  255  254  220    1  255  254  220    1  255  254  220    1  255  254  220    1  255  254  220    1  255  254  220    1  255  254  220    1  255  254  220    1  255  254  220    1  255  254  220    1  255  254  220    1  255  254  220    1  255  254  220    1  255  254  220    1  255  254  220    1  255  254  220    1  255  254  220    1  255  254  220    1  255  254  220    1  255  254  220    1  255  254  220    1  255  254  220    1  255  254  220    1  255  254  220    1  255  254  220    1  255  254  220    1  255  254  220    1  255  254  220    1  255  254  220    1  255  254  220    1  255  254  220    1  255  254  220    1  255  254  220    1  255  254  220    1  255  254  220    1  255  254  220    1  255  254  220    1  255  254  220    1  255  254  220    1  255  254  220    1  255  254  220    1  255  254  220    1  255  254  220    1  255  254  220    1  255  254  220    1  255  254  220    1  255  254  220    1  255  254  220    1  255  254  220    1  255  254  220    1  255  254  220    1  255  254  220    1  255  254  220    1  255  254  220    1  255  254  220    1  255  254  220    1  255  254  220    1  255  254  220    1  255  254  220    1  255  254  220    1  255  254  220    1  255  254  220    1  255  254  220    1  255  254  220    1  255  254  220    1  255  254  220    1  255  254  220    1  255  254  220    1  255  254  220    1  255  254  220    1  255  217  184    1  255    0    0    0  255
    0    0    0  255  255  231  136  255  254  220    1  255  254  220    1  255  254  220    1  255  254  220    1  255  254  220    1  255  254  220    1  255  254  220    1  255  254  220    1  255  254  220    1  255  254  220    1  255  254  220    1  255  254  220    1  255  254  220    1  255  254  220    1  255  254  220    1  255  254  220    1  255  254  220    1  255  254  220    1  255  254  220    1  255  254  220    1  255  254  220    1  255  254  220    1  255  254  220    1  255  254  220    1  255  254  220    1  255  254  220    1  255  254  220    1  255  254  220    1  255  254  220    1  255  254  220    1  255  254  220    1  255  254  220    1  255  254  220    1  255  254  220    1  255  254  220    1  255  254  220    1  255  254  220    1  255  254  220    1  255  254  220    1  255  254  220    1  255  254  220    1  255  254  220    1  255  254  220    1  255  254  220    1  255  254  220    1  255  254  220    1  255  254  220    1  255  254  220    1  255  254  220    1  255  254  220    1  255  254  220    1  255  254  220    1  255  254  220    1  255  254  220    1  255  254  220    1  255  254  220    1  255  254  220    1  255  254  220    1  255  254  220    1  255  254  220    1  255  254  220    1  255  254  220    1  255  254  220    1  255  254  220    1  255  254  220    1  255  254  220    1  255  254  220    1  255  254  220    1  255  254  220    1  255  254  220    1  255  217  184    1  255    0    0    0  255
    0    0    0  255  255  231  136  255  254  220    1  255  254  220    1  255  254  220    1  255  254  220    1  255  254  220    1  255  254  220    1  255  254  220    1  255  254  220    1  255  254  220    1  255  254  220    1  255  254  220    1  255  254  220    1  255  254  220    1  255  254  220    1  255  254  220    1  255  254  220    1  255  254  220    1  255  254  220    1  255  254  220    1  255  254  220    1  255  254  220    1  255  254  220    1  255  254  220    1  255  254  220    1  255  254  220    1  255  254  220    1  255  254  220    1  255  254  220    1  255  254  220    1  255  254  220    1  255  254  220    1  255  254  220    1  255  254  220    1  255  254  220    1  255  254  220    1  255  254  220    1  255  254  220    1  255  254  220    1  255  254  220    1  255  254  220    1  255  254  220    1  255  254  220    1  255  254  220    1  255  254  220    1  255  254  220    1  255  254  220    1  255  254  220    1  255  254  220    1  255  254  220    1  255  254  220    1  255  254  220    1  255  254  220    1  255  254  220    1  255  254  220    1  255  254  220    1  255  254  220    1  255  254  220    1  255  254  220    1  255  254  220    1  255  254  220    1  255  254  220    1  255  254  220    1  255  254  220    1  255  254  220    1  255  254  220    1  255  254  220    1  255  254  220    1  255  254  220    1  255  254  220    1  255  254  220    1  255  217  184    1  255    0    0    0  255
    0    0    0  255  255  231  136  255  254  220    1  255  254  220    1  255  254  220    1  255  254  220    1  255  254  220    1  255  254  220    1  255  254  220    1  255  254  220    1  255  254  220    1  255  254  220    1  255  254  220    1  255  254  220    1  255  254  220    1  255  254  220    1  255  254  220    1  255  254  220    1  255  254  220    1  255  254  220    1  255  254  220    1  255  254  220    1  255  254  220    1  255  254  220    1  255  254  220    1  255  254  220    1  255  254  220    1  255  254  220    1  255  254  220    1  255  254  220    1  255  254  220    1  255  254  220    1  255  254  220    1  255  254  220    1  255  254  220    1  255  254  220    1  255  254  220    1  255  254  220    1  255  254  220    1  255  254  220    1  255  254  220    1  255  254  220    1  255  254  220    1  255  254  220    1  255  254  220    1  255  254  220    1  255  254  220    1  255  254  220    1  255  254  220    1  255  254  220    1  255  254  220    1  255  254  220    1  255  254  220    1  255  254  220    1  255  254  220    1  255  254  220    1  255  254  220    1  255  254  220    1  255  254  220    1  255  254  220    1  255  254  220    1  255  254  220    1  255  254  220    1  255  254  220    1  255  254  220    1  255  254  220    1  255  254  220    1  255  254  220    1  255  254  220    1  255  254  220    1  255  254  220    1  255  254  220    1  255  217  184    1  255    0    0    0  255
    0    0    0  255  255  231  136  255  254  220    1  255  254  220    1  255  254  220    1  255  254  220    1  255  254  220    1  255  254  220    1  255  254  220    1  255  254  220    1  255  254  220    1  255  254  220    1  255  254  220    1  255  254  220    1  255  254  220    1  255  254  220    1  255  254  220    1  255  254  220    1  255  254  220    1  255  254  220    1  255  254  220    1  255  254  220    1  255  254  220    1  255  254  220    1  255  254  220    1  255  254  220    1  255  254  220    1  255  254  220    1  255  254  220    1  255  254  220    1  255  254  220    1  255  254  220    1  255  254  220    1  255  254  220    1  255  254  220    1  255  254  220    1  255  254  220    1  255  254  220    1  255  254  220    1  255  254  220    1  255  254  220    1  255  254  220    1  255  254  220    1  255  254  220    1  255  254  220    1  255  254  220    1  255  254  220    1  255  254  220    1  255  254  220    1  255  254  220    1  255  254  220    1  255  254  220    1  255  254  220    1  255  254  220    1  255  254  220    1  255  254  220    1  255  254  220    1  255  254  220    1  255  254  220    1  255  254  220    1  255  254  220    1  255  254  220    1  255  254  220    1  255  254  220    1  255  254  220    1  255  254  220    1  255  254  220    1  255  254  220    1  255  254  220    1  255  254  220    1  255  254  220    1  255  254  220    1  255  217  184    1  255    0    0    0  255
    0    0    0  255  255  231  136  255  254  220    1  255  254  220    1  255  254  220    1  255  254  220    1  255  254  220    1  255  254  220    1  255  254  220    1  255  254  220    1  255  254  220    1  255  254  220    1  255  254  220    1  255  254  220    1  255  254  220    1  255  254  220    1  255    0    0    0  255  254  220    1  255  254  220    1  255  254  220    1  255  254  220    1  255  254  220    1  255    0    0    0  255    0    0    0  255    0    0    0  255    0    0    0  255  254  220    1  255    0    0    0  255  254  220    1  255  254  220    1  255  254  220    1  255    0    0    0  255  254  220    1  255  254  220    1  255    0    0    0  255    0    0    0  255    0    0    0  255    0    0    0  255  254  220    1  255    0    0    0  255  254  220    1  255  254  220    1  255  254  220    1  255  254  220    1  255  254  220    1  255  254  220    1  255  254  220    1  255  254  220    1  255    0    0    0  255    0    0    0  255    0    0    0  255    0    0    0  255    0    0    0  255  254  220    1  255  254  220    1  255  254  220    1  255  254  220    1  255  254  220    1  255  254  220    1  255  254  220    1  255  254  220    1  255  254  220    1  255  254  220    1  255  254  220    1  255  254  220    1  255  254  220    1  255  254  220    1  255  254  220    1  255  254  220    1  255  254  220    1  255  254  220    1  255  254  220    1  255  217  184    1  255    0    0    0  255
    0    0    0  255  255  231  136  255  254  220    1  255  254  220    1  255  254  220    1  255  254  220    1  255  254  220    1  255  254  220    1  255  254  220    1  255  254  220    1  255  254  220    1  255  254  220    1  255  254  220    1  255  254  220    1  255  254  220    1  255  254  220    1  255    0    0    0  255  255  231  136  255  254  220    1  255  254  220    1  255  254  220    1  255    0    0    0  255  254  220    1  255  255  231  136  255  255  231  136  255  255  231  136  255  255  231  136  255    0    0    0  255  255  231  136  255  254  220    1  255  254  220    1  255    0    0    0  255  255  231  136  255    0    0    0  255  254  220    1  255  255  231  136  255  255  231  136  255  255  231  136  255  255  231  136  255    0    0    0  255  255  231  136  255  254  220    1  255  254  220    1  255  254  220    1  255  254  220    1  255  254  220    1  255  254  220    1  255  254  220    1  255    0    0    0  255  255  231  136  255  255  231  136  255  255  231  136  255  255  231  136  255  255  231  136  255  254  220    1  255  254  220    1  255  254  220    1  255  254  220    1  255  254  220    1  255  254  220    1  255  254  220    1  255  254  220    1  255  254  220    1  255  254  220    1  255  254  220    1  255  254  220    1  255  254  220    1  255  254  220    1  255  254  220    1  255  254  220    1  255  254  220    1  255  254  220    1  255  217  184    1  255    0    0    0  255
    0    0    0  255  255  231  136  255  254  220    1  255  254  220    1  255  254  220    1  255  254  220    1  255  254  220    1  255  254  220    1  255  254  220    1  255  254  220    1  255  254  220    1  255  254  220    1  255  254  220    1  255  254  220    1  255  254  220    1  255  254  220    1  255    0    0    0  255  255  231  136  255  254  220    1  255  254  220    1  255  254  220    1  255    0    0    0  255    0    0    0  255    0    0    0  255    0    0    0  255    0    0    0  255  254  220    1  255    0    0    0  255  255  231  136  255  254  220    1  255  254  220    1  255    0    0    0  255  255  231  136  255    0    0    0  255    0    0    0  255    0    0    0  255    0    0    0  255    0    0    0  255  254  220    1  255    0    0    0  255  255  231  136  255  254  220    1  255  254  220    1  255  254  220    1  255  254  220    1  255  254  220    1  255  254  220    1  255  254  220    1  255    0    0    0  255    0    0    0  255    0    0    0  255    0    0    0  255    0    0    0  255  254  220    1  255  254  220    1  255  254  220    1  255  254  220    1  255  254  220    1  255  254  220    1  255  254  220    1  255  254  220    1  255  254  220    1  255  254  220    1  255  254  220    1  255  254  220    1  255  254  220    1  255  254  220    1  255  254  220    1  255  254  220    1  255  254  220    1  255  254  220    1  255  254  220    1  255  217  184    1  255    0    0    0  255
    0    0    0  255  255  231  136  255  254  220    1  255  254  220    1  255  254  220    1  255  254  220    1  255  254  220    1  255  254  220    1  255  254  220    1  255  254  220    1  255  254  220    1  255  254  220    1  255  254  220    1  255  254  220    1  255  254  220    1  255  254  220    1  255    0    0    0  255  255  231  136  255  254  220    1  255  254  220    1  255  254  220    1  255    0    0    0  255  255  231  136  255  255  231  136  255  255  231  136  255  255  231  136  255  255  231  136  255  254  220    1  255    0    0    0  255  254  220    1  255    0    0    0  255  254  220    1  255  255  231  136  255    0    0    0  255  255  231  136  255  255  231  136  255  255  231  136  255  255  231  136  255  255  231  136  255    0    0    0  255  255  231  136  255  254  220    1  255  254  220    1  255  254  220    1  255  254  220    1  255  254  220    1  255  254  220    1  255  254  220    1  255  254  220    1  255  255  231  136  255  255  231  136  255  255  231  136  255    0    0    0  255  255  231  136  255  254  220    1  255  254  220    1  255  254  220    1  255  254  220    1  255  254  220    1  255  254  220    1  255  254  220    1  255  254  220    1  255  254  220    1  255  254  220    1  255  254  220    1  255  254  220    1  255  254  220    1  255  254  220    1  255  254  220    1  255  254  220    1  255  254  220    1  255  254  220    1  255  217  184    1  255    0    0    0  255
    0    0    0  255  255  231  136  255  254  220    1  255  254  220    1  255  254  220    1  255  254  220    1  255  254  220    1  255  254  220    1  255  254  220    1  255  254  220    1  255  254  220    1  255  254  220    1  255  254  220    1  255  254  220    1  255  254  220    1  255  254  220    1  255    0    0    0  255    0    0    0  255    0    0    0  255    0    0    0  255  254  220    1  255  254  220    1  255    0    0    0  255    0    0    0  255    0    0    0  255    0    0    0  255  254  220    1  255  254  220    1  255  254  220    1  255    0    0    0  255  254  220    1  255  255  231  136  255  254  220    1  255  254  220    1  255    0    0    0  255    0    0    0  255    0    0    0  255    0    0    0  255  254  220    1  255    0    0    0  255    0    0    0  255    0    0    0  255    0    0    0  255  254  220    1  255  254  220    1  255  254  220    1  255  254  220    1  255  254  220    1  255    0    0    0  255    0    0    0  255    0    0    0  255    0    0    0  255    0    0    0  255  255  231  136  255  254  220    1  255  254  220    1  255  254  220    1  255  254  220    1  255  254  220    1  255  254  220    1  255  254  220    1  255  254  220    1  255  254  220    1  255  254  220    1  255  254  220    1  255  254  220    1  255  254  220    1  255  254  220    1  255  254  220    1  255  254  220    1  255  254  220    1  255  254  220    1  255  217  184    1  255    0    0    0  255
    0    0    0  255  255  231  136  255  254  220    1  255  254  220    1  255  254  220    1  255  254  220    1  255  254  220    1  255  254  220    1  255  254  220    1  255  254  220    1  255  254  220    1  255  254  220    1  255  254  220    1  255  254  220    1  255  254  220    1  255  254  220    1  255  254  220    1  255  255  231  136  255  255  231  136  255  255  231  136  255  255  231  136  255  254  220    1  255  254  220    1  255  255  231  136  255  255  231  136  255  255  231  136  255  255  231  136  255  254  220    1  255  254  220    1  255  254  220    1  255  255  231  136  255  254  220    1  255  254  220    1  255  254  220    1  255  254  220    1  255  255  231  136  255  255  231  136  255  255  231  136  255  255  231  136  255  254  220    1  255  255  231  136  255  255  231  136  255  255  231  136  255  255  231  136  255  254  220    1  255  254  220    1  255  254  220    1  255  254  220    1  255  254  220    1  255  255  231  136  255  255  231  136  255  255  231  136  255  255  231  136  255  255  231  136  255  254  220    1  255  254  220    1  255  254  220    1  255  254  220    1  255  254  220    1  255  254  220    1  255  254  220    1  255  254  220    1  255  254  220    1  255  254  220    1  255  254  220    1  255  254  220    1  255  254  220    1  255  254  220    1  255  254  220    1  255  254  220    1  255  254  220    1  255  254  220    1  255  217  184    1  255    0    0    0  255
    0    0    0  255  255  231  136  255  254  220    1  255  254  220    1  255  254  220    1  255  254  220    1  255  254  220    1  255  254  220    1  255  254  220    1  255  254  220    1  255  254  220    1  255  254  220    1  255  254  220    1  255  254  220    1  255  254  220    1  255  254  220    1  255  254  220    1  255  254  220    1  255  254  220    1  255  254  220    1  255  254  220    1  255  254  220    1  255  254  220    1  255  254  220    1  255  254  220    1  255  254  220    1  255  254  220    1  255  254  220    1  255  254  220    1  255  254  220    1  255  254  220    1  255  254  220    1  255  254  220    1  255  254  220    1  255  254  220    1  255  254  220    1  255  254  220    1  255  254  220    1  255  254  220    1  255  254  220    1  255  254  220    1  255  254  220    1  255  254  220    1  255  254  220    1  255  254  220    1  255  254  220    1  255  254  220    1  255  254  220    1  255  254  220    1  255  254  220    1  255  254  220    1  255  254  220    1  255  254  220    1  255  254  220    1  255  254  220    1  255  254  220    1  255  254  220    1  255  254  220    1  255  254  220    1  255  254  220    1  255  254  220    1  255  254  220    1  255  254  220    1  255  254  220    1  255  254  220    1  255  254  220    1  255  254  220    1  255  254  220    1  255  254  220    1  255  254  220    1  255  254  220    1  255  254  220    1  255  217  184    1  255    0    0    0  255
    0    0    0  255  255  231  136  255  254  220    1  255  254  220    1  255  254  220    1  255  254  220    1  255  254  220    1  255  254  220    1  255  254  220    1  255  254  220    1  255  254  220    1  255  254  220    1  255  254  220    1  255  254  220    1  255  254  220    1  255  254  220    1  255  254  220    1  255  254  220    1  255  254  220    1  255  254  220    1  255  254  220    1  255  254  220    1  255  254  220    1  255  254  220    1  255  254  220    1  255  254  220    1  255  254  220    1  255  254  220    1  255  254  220    1  255  254  220    1  255  254  220    1  255  254  220    1  255  254  220    1  255  254  220    1  255  254  220    1  255  254  220    1  255  254  220    1  255  254  220    1  255  254  220    1  255  254  220    1  255  254  220    1  255  254  220    1  255  254  220    1  255  254  220    1  255  254  220    1  255  254  220    1  255  254  220    1  255  254  220    1  255  254  220    1  255  254  220    1  255  254  220    1  255  254  220    1  255  254  220    1  255  254  220    1  255  254  220    1  255  254  220    1  255  254  220    1  255  254  220    1  255  254  220    1  255  254  220    1  255  254  220    1  255  254  220    1  255  254  220    1  255  254  220    1  255  254  220    1  255  254  220    1  255  254  220    1  255  254  220    1  255  254  220    1  255  254  220    1  255  254  220    1  255  254  220    1  255  217  184    1  255    0    0    0  255
    0    0    0  255  255  231  136  255  254  220    1  255  254  220    1  255  254  220    1  255  254  220    1  255  254  220    1  255  254  220    1  255  254  220    1  255  254  220    1  255  254  220    1  255  254  220    1  255  254  220    1  255  254  220    1  255  254  220    1  255  254  220    1  255  254  220    1  255  254  220    1  255  254  220    1  255  254  220    1  255  254  220    1  255  254  220    1  255  254  220    1  255  254  220    1  255  254  220    1  255  254  220    1  255  254  220    1  255  254  220    1  255  254  220    1  255  254  220    1  255  254  220    1  255  254  220    1  255  254  220    1  255  254  220    1  255  254  220    1  255  254  220    1  255  254  220    1  255  254  220    1  255  254  220    1  255  254  220    1  255  254  220    1  255  254  220    1  255  254  220    1  255  254  220    1  255  254  220    1  255  254  220    1  255  254  220    1  255  254  220    1  255  254  220    1  255  254  220    1  255  254  220    1  255  254  220    1  255  254  220    1  255  254  220    1  255  254  220    1  255  254  220    1  255  254  220    1  255  254  220    1  255  254  220    1  255  254  220    1  255  254  220    1  255  254  220    1  255  254  220    1  255  254  220    1  255  254  220    1  255  254  220    1  255  254  220    1  255  254  220    1  255  254  220    1  255  254  220    1  255  254  220    1  255  254  220    1  255  217  184    1  255    0    0    0  255
    0    0    0  255  255  231  136  255  254  220    1  255  254  220    1  255  254  220    1  255  254  220    1  255  254  220    1  255  254  220    1  255  254  220    1  255  254  220    1  255  254  220    1  255  254  220    1  255  254  220    1  255  254  220    1  255  254  220    1  255  254  220    1  255  254  220    1  255  254  220    1  255  254  220    1  255  254  220    1  255  254  220    1  255  254  220    1  255  254  220    1  255  254  220    1  255  254  220    1  255  254  220    1  255  254  220    1  255  254  220    1  255  254  220    1  255  254  220    1  255  254  220    1  255  254  220    1  255  254  220    1  255  254  220    1  255  254  220    1  255  254  220    1  255  254  220    1  255  254  220    1  255  254  220    1  255  254  220    1  255  254  220    1  255  254  220    1  255  254  220    1  255  254  220    1  255  254  220    1  255  254  220    1  255  254  220    1  255  254  220    1  255  254  220    1  255  254  220    1  255  254  220    1  255  254  220    1  255  254  220    1  255  254  220    1  255  254  220    1  255  254  220    1  255  254  220    1  255  254  220    1  255  254  220    1  255  254  220    1  255  254  220    1  255  254  220    1  255  254  220    1  255  254  220    1  255  254  220    1  255  254  220    1  255  254  220    1  255  254  220    1  255  254  220    1  255  254  220    1  255  254  220    1  255  254  220    1  255  217  184    1  255    0    0    0  255
   58   53   46  255    0    0    0  255  217  184    1  255  217  184    1  255  217  184    1  255  217  184    1  255  217  184    1  255  217  184    1  255  217  184    1  255  217  184    1  255  217  184    1  255  217  184    1  255  217  184    1  255  217  184    1  255  217  184    1  255  217  184    1  255  217  184    1  255  217  184    1  255  217  184    1  255  217  184    1  255  217  184    1  255  217  184    1  255  217  184    1  255  217  184    1  255  217  184    1  255  217  184    1  255  217  184    1  255  217  184    1  255  217  184    1  255  217  184    1  255  217  184    1  255  217  184    1  255  217  184    1  255  217  184    1  255  217  184    1  255  217  184    1  255  217  184    1  255  217  184    1  255  217  184    1  255  217  184    1  255  217  184    1  255  217  184    1  255  217  184    1  255  217  184    1  255  217  184    1  255  217  184    1  255  217  184    1  255  217  184    1  255  217  184    1  255  217  184    1  255  217  184    1  255  217  184    1  255  217  184    1  255  217  184    1  255  217  184    1  255  217  184    1  255  217  184    1  255  217  184    1  255  217  184    1  255  217  184    1  255  217  184    1  255  217  184    1  255  217  184    1  255  217  184    1  255  217  184    1  255  217  184    1  255  217  184    1  255  217  184    1  255  217  184    1  255  217  184    1  255  217  184    1  255  217  184    1  255    0    0    0  255   47   42   35  255
   44   40   33  255   59   54   47  255    0    0    0  255    0    0    0  255    0    0    0  255    0    0    0  255    0    0    0  255    0    0    0  255    0    0    0  255    0    0    0  255    0    0    0  255    0    0    0  255    0    0    0  255    0    0    0  255    0    0    0  255    0    0    0  255    0    0    0  255    0    0    0  255    0    0    0  255    0    0    0  255    0    0    0  255    0    0    0  255    0    0    0  255    0    0    0  255    0    0    0  255    0    0    0  255    0    0    0  255    0    0    0  255    0    0    0  255    0    0    0  255    0    0    0  255    0    0    0  255    0    0    0  255    0    0    0  255    0    0    0  255    0    0    0  255    0    0    0  255    0    0    0  255    0    0    0  255    0    0    0  255    0    0    0  255    0    0    0  255    0    0    0  255    0    0    0  255    0    0    0  255    0    0    0  255    0    0    0  255    0    0    0  255    0    0    0  255    0    0    0  255    0    0    0  255    0    0    0  255    0    0    0  255    0    0    0  255    0    0    0  255    0    0    0  255    0    0    0  255    0    0    0  255    0    0    0  255    0    0    0  255    0    0    0  255    0    0    0  255    0    0    0  255    0    0    0  255    0    0    0  255    0    0    0  255    0    0    0  255    0    0    0  255    0    0    0  255    0    0    0  255    0    0    0  255    0    0    0  255   33   29   25  255   35   31   27  255
