###################
#                 #
#        OOO  ##  #
#                 #
#          #   #O #
#          O   #O #
#       O  ##OO#O #
#  $    O  O    O #
#  $    #  ##  ## #
#  $   O#OOOO     #
#      OOO        #
#  $   O#O        #
#       #         #
#O O#######OOOOOO #
#   OOOOOOO       #
#                 #
#                 #
#                 #
#                 #
###################