####################
#               #  #
#O   #  ## OOO######
#                  #
#OO    ########O####
#  #     #    # #  #
#        #         #
#  #  #O##### # #  #
#     O     #      #
##OO###  #  ########
#     #     #      #
#  #  #####O# # #  #
#     #  #  #      #
#  #     #  # # #  #
#     #  #         #
# OOO##### O#O ## O#
#                  #
###### ## ## ## O  #
# #                #
####################