####################
#                  #
#                  #
#                  #
#                  #
#                  #
#     # #####      #
#     #     #      #
#######  #  ########
#     #     #      #
#     ##### #      #
#                  #
#                  #
#                  #
#                  #
#                  #
#                  #
#                  #
#                  #
####################