####################
#                  #
#        OOO OOOO  #
##  #     #  # # # #
#   OO  OOOOOOOOO  #
#  #     #    # #  #
#  O     # O  OO   #
#         OOO  O   #
#  O  O     #      #
#  O  O     #      #
#     #     #      #
#  O  O            #
#     #  #  #      #
#  #     #  # # #  #
#  O  #  #         #
#  O  O     #      #
#  O  O     #      #
#  OOOOOOO         #
#  O            #  #
####################