####################
#     ########     #
# OOO ###  ### OOO #
# OOO ######## OOO #
#                  #
#                  #
######        ######
######        ######
##  ##        ##  ##
##  ##        ##  ##
##  ##        ##  ##
##  ##        ##  ##
######        ######
######        ######
#                  #
#                  #
# OOO ######## OOO #
# OOO ######## OOO #
#     ##    ##     #
####################