####################
#       ####       #
#OOOO    OOO OOOO  #
#  #     #  # # #  #
#   OO  OO     OO  #
#  #     #    # #  #
#  O     # O  OO   #
#         OOO  #   #
#  O  O     #      #
#  #     #  # #O#  #
#     #            #
#  O  O            #
#  #     #  # # #  #
#  #     # O# # #  #
#  O  #  # O       #
#  #     # O# # #  #
#  O  O     #   #  #
#  OOOOOOO     O#  #
#  O            #  #
####################