####################
#                  #
################## #
#                # #
# ############## # #
# #            # # #
# # ########## # # #
# # #          # # #
# # #OOOOOOOOOO# # #
# # #OOOOOOOOOO# # #
# # #OOOOOOOOOO# # #
# # #OOOOOOOOOO# # #
# # #          # # #
# # # ########## # #
# # #            # #
# # ############## #
# #                #
# ##################
#                  #
####################