##################
#P  #            #
#   O    OOO  ## #
#   #            #
#OOO#      #   #O#
#   #      O   #O#
#       O  ##OO#O#
#  $    O  O    O#
#  $    #  ##  ###
#  $   O#OOOO    #
#      OOO       #
#  $   O#O       #
#       #        #
#OOO#######OOOOOO#
#   OOOOOOO      #
#    #OOO#       #
#    # O #       #
#    #OOO#     OO#
#           O  OX#
##################