####################
#               #  #
#O######## OOO######
#                  #
#OOOO##########O####
#  #     #    # #  #
#     #  #         #
#  #  #O##### # #  #
#     #     #      #
#######  #  ########
#     #     #      #
#  #  #####O# # #  #
#     #  #  #      #
#  #     #  # # #  #
#     #  #         #
# OOO##### O#O ## O#
#                  #
###### ## ## ## OO #
# #                #
####################