####################
#                  #
#   OOOOOOOOOOOOO  #
##  #     #  # # # #
#   OOOOOOOOOOOOO  #
#  #     #    # #  #
#  O     #         #
#  O               #
#  O  O     #      #
#  O  O     #      #
#  O  #     #      #
#  O  O     #      #
#  O  #  #  #      #
#  #     #  # # #  #
#  O  #  #         #
#  O  O     #      #
#  O  O     #      #
#  OOOOOOOOOOOOO####
#  O            # ##
####################